poprawne zachowanie - Proper etiquette, behave/act accordingly
człowiek uczy się całe życie - You live and learn
nadmiernie uprzejmy - Excessively/overly polite
Uprzejmy - courteous, well-mannered
Dziwny - peculiar
Charakterystyczne cechy - distinctive characteristics
Sprawiać wrażenie - come across as/give the impression of
Zwyczajowe - customary
Zwykle - ordinarily/habitually
Wydało się dziwne - struck me as odd
Wprawić w zakłopotanie - perplex/puzzle
Odwalić coś ajajaj - put your foot in your mouth
FO PA - make a blunder
Zrobić nietaktowną uwagę - make a tactless remark, make a gaffe
Upset people with smth - rock the boat
Obstruct - utrudniać (obstructiveness)
Spłaszczony - oversimplified, overgeneralized
Podtrzymywać stereotyp - perpetrate the stereotype of
Rozwiać - dispel,renounce
Trzymać się - cling to
Wzmacnia - reinforces
Przeciwstawić się - defy, challenge
Odrzucić - discard, dispel
Przypuszczenie - assumption
Pogląd - notion
Sprzeczka - squabble
Drobna kłótnia - petty quarrel
Poważna pogadanka - have a word with sb
Zniechęcić - put sb off, appall, throw sb
Zawieść kogoś - disappoint, dismay
Rozczarować - disenchant
Popierać - condone
Tolerować - abide, tolerate
Przestrzegać zasad - abide by rules
Utrzymywać relacje - keep in with
Pojąć - comprehend
Przetrawić sobie - digest
Pojąć - grasp
Pojąć - come to grips with / wrap your head around
Wsparcie - aid
Bronić - advocate
Wspierać - stand by someone
Aprobować - endorse
Zagraniczny - overseas
Spotkanie na szczycie - summit meeting
Świadomość - awareness
Kulturalny - cultivated,cultured ~boorish
Przywiązać wagę - attach importance
Popierać pomysł - embrace the idea
Szykować się - gear up for, brace yourself
 

Cecha narodowa - national characteristics
Centralne dla tożsamości - central to their identity
Pogląd na życie - outlook on life
Ujmujący - endearing
Powstrzymać się od emocji - keep a stiff upper lip, restrain yourself
Niechętny - reluctant
Skromny - modest, shy
Opanowanie - composure
Niepozorny - unassuming, unpretentious
Arogancki - self-important, smug, conceited
Apodyktyczny (despota - nieznoszący sprzeciwu) - overbearing, bossy
Gorliwy - zealous
Obłudny (dwulicowy, hipokryta) - self - righteous
Świętoszkowaty - sanctimonious
Samoświadomy - self-aware, self-conscious,self-contented
Zadowolenie - contentment (jestem kontent i rad)
Sztuczność - affectation
Sztuczne zachowanie - mannerism
Atencjusz - manneristic
Udawać kogoś - pass for sb
Na pokaz - act with pretense, ostentatious
Zaborczy - invasive
Impinge - naruszać
Przerost formy nad treścią - triumph of form over substance/content
Pozer - ass in lion’s skin
Zszokować - confound
Zszokowany - flabbergasted
Być bez słów - speechles, lost for words
Nie mam słów! - words fail me!
Nie da się z tobą gadać - there is no reasoning with you
Nie pozwole na to - I won’t stand for that
Źle widziane - frowned upon
Confused przez niezrozumienie sie, gadanie o czyms innym - get your wires crossed
Zderzyć się - cross/clash with sb
Nadepnąć na odcisk - tread on toe
Zderzenie kultur - clash of cultures
Rozstrzygnąć dysputę - iron out differences
Znaleźć kompromis - reach an accommodation
Konsensus - forge out a consensus
źle ocenić kogoś - be under a false impression, misread, misjudge
Trzymać w braku szacunku - hold in disrespect, look down on somebody
Nieuprzejmy - discourteous, ill-mannered
Szydzić - deride
Ubliżać - disparage
Wytknąć coś komuś - make a disparaging remark
Uprzedzenia - preconceptions
Tendencyjny - preconceived
Odsunąć coś na drugi plan - brush aside
 
Struktura rządu - governmental machinery
Władze - authorities
Osoba publiczna - public figure
Osoba rozpoznawalna/zasłużona - distinguished person
Znana osobowość/wielkie nazwisko, gruba ryba - a big name, big cheese, top dog
Osoba przy władzy - person in authority
Wpłw - influence
Enviable position - godne pozazdroszczenia stanowisko
Stanowić przykład - set a good example
Chwalebne - commendable, praiseworthy
Paradygmat - paradigm
Nowy standard, punkt odniesienia - new standard, set a new benchmark
Szanować - look up to
Szanować - hold in respect, regard highly
Szacunek - regard, high esteem
Zejść na psy - go to the dogs
Zepsuło się - went to pot, went downhill
wybrukowana dobrymi chęciami - ROAD TO HELL IS PAVED WITH GOOD INTENTIONS
Obecna międzynarodowa afera - current international affair (affair tez romans)
Być zamieszanym - get involved, mixed up, implicated in
Interweniować - intervene in
Przeszkadzać - interfere
Wtykać nochala - stick your nose
Żądanie o coś - demand for
Spełnić - fullfill
Wdrożyć nową politykę/prawo - implement a new policy
Przyjąć nową politkę - adopt a new policy
Zreformować - reform,modify,alter
Rzecznik prasowy - spokesperson
Obwieszczenie - announcement, statement, declaration
Wziąć się za (złe zachowania) - crack down on!
Narzucić na ludzi - impose on people, force upon society, FOIST
Narzucenie/nałożenie - imposition
Ustawodawstwo - legislation
Modyfikowanie - amending
Ustanowić nowe prawo - pass a new bill / law
Pod żadnym warunkiem - under no circumstances
ON NO CONDITION SHOULD YOU
Obecna - current/present
Polityka niewtrącania się - policy of nonintervention / noninterference
Korytarz władzy - corridors of power
Jest dyskutowana - is being discussed/addressed
Rozważać - ponder/ reflect upon / MULL OVER / deliberate
 
Angażować się w kłótnię - engage in an argument
Argument - point, argument
rozWAŻYĆ - weigh
Przemyśleć - take account of sth
Pozastanawiać się - CHEW ON/OVER, contemplate
UPON REFLECTION I ARRIVED AT THE CONCLUSION
Zignorować - leave out of account
Lekceważyć - disregard, BLOND/DEAF to SOMETHING ( blind ? )
Mieć gdzieś - turn a blind eye to sth
Zbyć kogoś - fob sm off
Odwrócić się do kogoś plecami - turn your back ON
Tajny program - secret agenda
Notowania rosną - rate is on the rise
oSzCzĘdNy Z pRaWdą xD - economical with the truth
Poprawny politycznie - political correct
Podporządkować się - toe the line
Bzdura - humbug, talk the hot air
Kara I nagroda - carrot-and-stick method
Wyrazić dezaprobatę - express disapprobation/disapproval
Establiszment - grono osob sprawujacych wladze, establishment
Przeciwstawiać się - defy
Bunt - defiance
Niesubordynacja - disobey, insubordinate
Przeciwstawić się - turn against
Mieć kogoś pod pantoflem - bring sb to heel
Tańczyć jak nam zagrają - dance to sb’s tune
Sztuczka polityczna - political gimmick
Kto ciągnie za sznurki - pulling the strings
Rządzić twarda ręką - heavy hand/ iron fist
Mieć nad kimś władze - have somebody in your pocket
Kontrolować kogoś - have sb under your thumb
Dojść do mocniejszej pozycji - gain the upper hand
Kiełbasa wyborcza - political hot potato
Iść pod prąd - go against the grain (grain - ziarno)
Zastopować coś - put your foot down
Cisnąć kogoś - put the squeeze on sb
Niepoprawne - out of line
Postawić się - come out against
Ucieć z sytuacji - bail out
Uchylać się od odpowiedzialności - SHRINK FROM your responsibility
Robić dobrą mine do złej gry - GRIN AND BEAR IT
Narysować linię - draw a line IN THE SAND
Przesadzić - cross the line
Uspokój się! - keep your shirt on!
Wstrzymać konie - HOLD YOUR HORSES!
BARDZO się zdenerwować - BLOWING YOUR TOP
Szambo wylało - SHIT HIT THE FAN
Bardzo wrażliwy temat - A VERY sensitive topic
Wkurzyć kogoś - hit the nerve
Nagle sie zdenerwowac I nie kontrolowac się - loose your cool
Robić jaja z kogoś - HAVING A GO AT SB
